1111111111111111111111111111111
100P0000C0000000000000000000C01
100000X1111001000X10000X0C00X01
11111000XE1C0X00XC1C00X11111001
10C00X1000100C00001111110000001
10100C10001111111000000001X0001
10C10000001000000001111111C0X01
110C11111C1C1XX1X101C0000000001
1X10000000100000C10100100000001
1XX111111111111101010111000CXC1
1000000C0000000001011X1X100XC01
101X1XX11111111111010C1XX10CXC1
101000X000000000000000111101111
1C10101C11111111111110100000001
1010101C00000000000010101111101
1010101X111111111110101000C0001
1000XC0000CC00000C00X000CXXXC01
1111111111111111111111111111111