1111111111111111111111111
11100C00000P00000C000C111
11001100110000111111C0011
100011C011000011111100001
10001100110C0000C011C0001
1000111111000011111100001
1000111111000011111100C01
100000E011000011000000001
10000000110C001111110C001
1100000011000011111100011
1110C00000000000000C00111
1111111111111111111111111